BBBBBBBBBBBBBBBBBBBBBBBBBBBBBBBBBBBBBBBB
B@                   B                 B
B                    B                 B
B    @  @            B                 B
B    @  @          *                   B
B    @  @                              B
B    @@@                   *           B
B              *                       B
B                                      B
B                                      B
B                                      B
BBBBBBBBBBBBBBBBBBBBBBBBBBBBBBBBBBBBBBBB
